"a" = (/obj/effect/turf_decal/stripes/line{dir = 10},/obj/structure/window/plasma/reinforced,/obj/machinery/light/floor,/turf/open/floor/engine,/area/shuttle/entrance_elevator)
"b" = (/obj/effect/turf_decal/stripes/line{dir = 4},/turf/open/floor/engine,/area/shuttle/entrance_elevator)
"f" = (/obj/effect/turf_decal/stripes/line{dir = 4},/obj/effect/turf_decal/caution{dir = 4},/turf/open/floor/engine,/area/shuttle/entrance_elevator)
"k" = (/obj/effect/turf_decal/stripes/line{dir = 6},/obj/structure/window/plasma/reinforced,/obj/machinery/light/floor,/turf/open/floor/engine,/area/shuttle/entrance_elevator)
"l" = (/obj/effect/turf_decal/stripes/line{dir = 5},/obj/structure/window/plasma/reinforced{dir = 1},/obj/machinery/light/floor,/turf/open/floor/engine,/area/shuttle/entrance_elevator)
"q" = (/obj/docking_port/mobile/elevator{dir = 8; dwidth = 1; height = 4; id = "entrance_elevator"; name = "BOS Entrance Elevator"; width = 6},/obj/effect/turf_decal/caution{dir = 4},/obj/effect/turf_decal/stripes/line{dir = 4},/turf/open/floor/engine,/area/shuttle/entrance_elevator)
"G" = (/obj/machinery/computer/shuttle/bosentryelevator{dir = 4},/turf/open/floor/engine,/area/shuttle/entrance_elevator)
"I" = (/obj/effect/turf_decal/stripes/line,/obj/structure/window/plasma/reinforced,/turf/open/floor/engine,/area/shuttle/entrance_elevator)
"O" = (/obj/effect/turf_decal/caution{dir = 8},/obj/effect/turf_decal/stripes/line{dir = 8},/turf/open/floor/engine,/area/shuttle/entrance_elevator)
"P" = (/turf/open/floor/engine,/area/shuttle/entrance_elevator)
"T" = (/obj/effect/turf_decal/stripes/line{dir = 8},/turf/open/floor/engine,/area/shuttle/entrance_elevator)
"W" = (/obj/effect/turf_decal/stripes/line{dir = 1},/obj/structure/window/plasma/reinforced{dir = 1},/turf/open/floor/engine,/area/shuttle/entrance_elevator)
"Y" = (/obj/effect/turf_decal/stripes/line{dir = 9},/obj/structure/window/plasma/reinforced{dir = 1},/obj/machinery/light/floor,/turf/open/floor/engine,/area/shuttle/entrance_elevator)
"Z" = (/obj/effect/turf_decal/stripes/line{dir = 8},/obj/effect/turf_decal/caution{dir = 8},/turf/open/floor/engine,/area/shuttle/entrance_elevator)

(1,1,1) = {"
YWWl
ZPPf
TGPb
OPPq
aIIk
"}
